SO ./imgs/b_m.xpm
WE ./imgs/r_m.xpm
EA ./imgs/y_m.xpm
NO ./imgs/g_m.xpm

C 200,200,240
F 40,180,40

1111111
1000001
       
100N001
1111111